111111111111
100001000001
100P01000001
100C0100C001
10C00100E001
111111111111