1111111111111
10C10000000C1
100001000C001
1P0C01E000001
1100111111111
1101101000111
11C0101111C11
1110000000011
11101C1011111
100C10110C011
1110000000011
1111111111111