11111
10P01
100C1
1E001
10001
