111111
1P0001
1C0E01
10P001
111111