111111
1P0001
1C0E01
100001
111111